NO ./assets/wp1.png
SO ./assets/wp2.png
WE ./assets/wp3.png
EA ./assets/wp4.png


F 0,0,167
C 0,191,255 





11111111111111111111
11000000000000000001
11000000000000000001
11000000000000000001
11100000000000000001
10000000000000100001
111000N0000000000001
11000000000000000001
10000000000000000001
11111111111111111111